16 27
000000000000000000000000000
000000000000000000000000000
311111111111111111111111112
311111111111111111111111112
001100000000001111110000000
001100000000001111110000000
000000000000001111111111100
000000011111111111111111100
000000011111111111111111100
000000000011001111111111100
000000000011001111111111100
000000000011001111111111100
000000000011001111111111100
000000000011000000000000000
000000000011000000000000000
000000000022000000000000000