16 27
000000000022000000000000000
000111111111111111111100000
000110000000000000001100000
001111111100000011111100000
001111111100000011111111110
000000110000000011111100110
000111110000000011111100110
000111111000000000000000110
001111110000000000000000110
001111110000001111111111112
000111110111111111110000000
000111110111111111110000000
000000000110011100110000000
000000000110011100110000000
011111111111111111111111112
011111111111111111111111112
000000000000000000000000000