16 27
000000000222000000000000000
000000000111000000111110000
000000000111000000110110000
000000000111000000110110000
000000000111000000000010000
000000000111000000000010000
000000000111000000000010000
000000000111111111111111100
000000000111000000001111100
211111111111000000001111100
000000000111000000000000000
000000000111000000000000000
000000000111000000000000000
000000000111000000000000000
211111111111111111111111110
211111111111111111111111110
000000000000000000000000000