16 27
000000000000000000000000000
000000000000000000000000000
001111111111111111111111111
001111111111111111111111111
001100011000001111110000000
001100011000001111110000000
000000011000001111111111100
000000011111111111111111100
000000011111111111111111100
000000000011001111111111100
000000000011001111111111100
000000000011001111111111100
000000000011001111111111100
000000000011000000000000000
000000000011000000000000000
000000000011000000000000000