16 27
000000000000000000000000000
000000000000000000000000000
211111111111111111111111113
211111111111111111111111113
000000001111100000000000110
000000000111000000111100110
000000000111000000111111110
000000000111000000110000110
000000000111000000000000110
000000000111000001111111110
000000000111000001111111100
000000000111000000000110000
000000000111000000000110000
000000000111000111111110000
000000000111000111111110000
000000000222000000000000000